ADMAPU: Imagen, mapa, faz de la Tierra.
ADH: Faz, cara, fisonomía, frente, exterior de algo,rostro, aspecto de algo, Costumbre, tradición.
ADHMAPU: Conjunto de preceptos y costumbrestransmitidas a través de las generaciones, expresión de todo lo consagrado por el uso de los ancestros y constitutivo de la ley indígena.
ADHN: Armónico, bonito de buen aspecto.
ADHENTUN: Imitar, copiar.
ADKAN: Ordenar, enfrentar, oponerse, decidir.
ADHENTU: Foto, imagen.
ADHNGELL: Simulación, simbólico.
ADHKPA: Antiguo, ancestral, tradicional.
ADHKNUN: Dejar establecido, dejar arreglado.
ADHKINTUN: Mirar, lograr ver, mirar lejos.
ADHNGUN: Hablar bien, hablar en forma coherente.
ADHMONGEN: Estilo de vida.
ADHN: Ser bonito.
ADHTKUN: Arreglar.
ADHTRIPAN: Salir, bien, salir airoso.
ADHMN: Saber, aprender.
AIE: Risa.
AIEN: Reír, sonreír.
AIWN: Alegría, alegrarse.
AIU KIAWN: Andar alegre, contento.
AIU LUWN: Dejarse querer, enamorarse.
AIN: Querer, amar, querido (a).
AIE KAWE: Lugar de alegría, divertido.
AIETUFE (BE): Burlesco, Se ríe de alguien.
AIULAI: No se alegró.
AIUWI: Se alegró.
AIEKAN: Fiesta, diversión.
AIEKALFE: Chistoso, persona que hace reír.
AIENWE: Lugar de diversión o divertido.
AIEKANDNGU: Tema de alegría.
AIUKIAUMUN: Andar contento, alegre.
AIN: Lindo, bonito.
AINCHE: Persona simpática.
AIULUMN: Querer, enamorarse.
AIFAL: Querible, agradable.
AILEN: Brasa, tizón de fuego.
AILIN: Cristalino, transparente.
AILINKO: Agua transparente, limpio.
AILLA: Nueve.
AILLA MARHI: Noventa.
AILLA PATAKA: Novecientos.
AFLAIAI: Eterno, infinito, interminable.
AF: Nada.
AFCHEMU: Despoblado.
AFPUI: Límite, terminación, final.
AFANTG: Al final del día.
AFKADHI: Compañero, par, alguien de confianza.
AFKG DHUAM: Suspiro, lamento, tristeza.
AF LAFKEN: Fin del mar.
AFMAN: Escasez, padecer de necesidad.
AFLN: Cocer en seco o hervir.
AFPUM MAPU: Contorno de la Tierra, frontera.
ACHAWALL: Pollo, gallina.
AM: Alma.
AMUL KG-IEN: CALENDARIO
ANGE: Cara, rostro.
ALWEMAPU: Tierra de los espíritus, País de los
espíritus.
ALKA: Gallo, macho.
ALIWEN: Árbol.
ALEN: Luminosidad de la Luna.
ALENGEI: Está clara la noche.
ALG MAPU: Lugar distante, lejos. Territorio amplio.
ALWE: Fantasma, ánima.
ALWE CHEL: Fantasma con forma humana.
ALWE MAPU: Tierra de los muertos.
ALLMALL: Menos mal, que bueno.
ALLKN: Escuchar, oír.
ALLK GWE: Oído.
ALLK TUWE: Lugar donde escuchar.
ALLK TUPAN: Vine a escuchar.
ALLK TUPEN: Estoy escuchando.
ALLKTU PAPEN: Vine a escuchar.
ANGE: Rostro, cara.
ANTG/ ANTÜ: Sol, día.
ANüNGE: Siéntate o toma asiento.
AILEN: Brasa encendida.
ADKPA: Costumbre, tradición, rutina.
ADHELCHEN: Saber tratar a la gente.
ANKEN: Seco.
ANG KGNAG: Proceso de secado
ANTG ÑMAIÑ; Nos encontró el Sol.
ANTG-LEF: Sol Ligero, Día fugaz.
ANTGNAG: Sol bajo o sol entrante.
ANTGKO: Aguada del Sol.
ANTG MAÑKE: Cóndor Reluciente.
ATREG: Frío
AILLA PANGI: Nueve pumas.
ANGKA: Mitad, un poco.
ANGWE: Sentadera.
AKUN: Llegar acá.
AKUTUN: Llegar otra vez, regresar.
AKULN: Traer.
AKUN LEGFG: Lugar donde llega el río.
ALNCHE: Harta gente.
AILLA KOIAM: Nueve robles.
AILLA RHEWE: Nueve comunidades unidas por un pacto político de defensa mutua y el reconocimiento de sus integrantes a un jefe o gobernador, el ngidol lonko.
ARHEN: Calor.
ARHENKO: Agua caliente.
ALN: Harto, mucho.
ALGKURHA: Piedra grande.
ALING: Ardor, caliente.
ALIWEN: Árbol.
ALON: Luminosidad, foco de luz.
ALNPIKNUN: Charlatán.
ALGPRHA: Alto.
AMUN: Ir, avanzar.
AMUTUN: Irse.
AMUNCHE: Viajero, andante, caminante.
AMUKAN: Realizar viaje e ir.
AMUKONN: Grave, estar mal.
AMULEN: Progresar, avanzar, caminado.
AMUL KG-IEN: CALENDARIO
AMPANGE: Ven.
AMPELL: Deseo.
ANGKA: Un poco cantidad.
ANGKAO: None.
ANGKG: Seco.
ANGKEN: Seco.
ANG-LEN: Estar seco.
ANTG: Sol y/o día.
ANTGLKO: Agua asoleada.
ANTGLWE: Lugar asoleado.
ANTGLLANKA: Piedrecilla del sol.
ANTGKNL: Familia del sol.
ANTGFILU: Culebra del sol.
ANTGKO: Agua del sol.
ANTGNGEN: Dueño del sol.
ANTGMALAL: Corral del sol.
ANÜMKA: Planta, sembrado.
ANNWE: Asiente, silla.
ANNWERHAKI: Asiento de bandurrias.
APOL: Pulmón del animal aliñado se consume fresco.
ARHKN: Agua que se ha secado.
ARHKENKO: Agua reducida.
ARHKGLAFKEN: Mar seco.
ARHEI ANTG: Sol caluroso.
AREHNGEI: Hace calor.
ATENKURHA: Piedra triturada.
ATRHGKO: Agua fría.
AUKA: Alzad, rebelde, indomable.
AUKAN: Silvestre,
AUKATUN: Jugar.
AUKAPANGUI: Puma indomable.
AUKIÑ: Eco.
AUKIÑKO: Eco del agua.
AWELN: Rápido
AFIKO: No hay más agua.
ANTGKURHA: Piedra del sol.
ANGKEN KUTRHAN: Tuberculosis.
ANGKAMILLA: Con un poco de oro
ANGKARHEPG: A mitad de camino.
ANGRHUPAN: Pasar a tomar asiento.
AÑCHIMALLEN: Duende pequeño.
ALGPRHAN: Ascender a gran altura.
BAU O FAU: Aquí
BAUPLE o FAUPLE: Por aquí.
BACAHNTG o FACHANTG: Hoy día.
BAIN o FAIN: Fermentar.
BANEI o FANEI: Pesado.
BEIKAI O FEIKAI: Basta.
BEICHI o FEICHI: Ese, eso, aquel o aquello.
BEIKACHIO FEIKACHI: Enseguida, luego o de inmediato.
BELEI O FELEI: Bien, está bien, de acuerdo u OK.
BEINGEI o FEINGEI: Verdadero, cierto.
BERHG o FERHG: Cebo, suciedad, mugre.
BELEI o FELEI: Bien, está bien, muy bien.
BEULA O FEULA: Ahora.
BILL o FILL: Todos.
BILLKUÑ o FILLKUÑ: Lagartija, Lagarto.
BILU o FILU: Culebra, Serpiente.
BILLA o FILLA: Escasez.
BILLAD o FILLAZ: Envidioso.
BL o FL: Cerca.
BN o FN: Fruto.
BOIE o FOIE: Canelo, es uno de entre los cuatro
arboles sagrados del Pueblo Mapuche.
BOTRA o FOTRA: Barro.
BOLIL o FOLIL: Raíz, aborigen.
BGHU o FGHU: Hilo, lana procesada.
BOROWA o FORHOWA: Coronta de Choclo.
BORHO o FORHO: Hueso o diente, depende del
contexto de la frase o conversación.
BOTM o FOTM: Hijo por parte del padre.
BOKI o FOKI: Enredadera, enredadera que crece en la sombra en medio del bosque más frondoso, es una enredadera tupida en que se fábrica todo tipo de cestería como; llepg, klko o chaiwe, paneras, canasto se elabora fibra fina para coser o amarrar en la construcción de la rhuka, también para cordel para animales.
BOCHAN o FOCHAN: Rastrojo.
BGTA o FGTA: Esposo, cónyuge.
BDG o FDG: Perdiz.
BUWN o FUWN: Hilar.
BUNA o FUNA: Abono.
BUNAI o FUNAI: Podrido.
BURHE o FURHE: Picante.
BUCHEN o FUCHEN: Silvestre.
BIO-BIO o FIU-FIU: Pájaro que canta Fiufiu.
BOLU o FOLU: Árbol o arbusto medicinal que contiene un alcaloide, la boldina. Es de hojas ásperas, coriáceas, fragantes,follaje verde oscuro,frutos dulces.
BGTAKOIAM o FGCHAKOIAM: Inmenso roble, roble grande.
CHALLWA: Pescado.
CHALLWATUN: Comer o consumir pescado.
CHALLWAN: Pescar.
CHALLWAPAN: Venir a pescar.
CHALIN: Saludar, encuentro.
CHALITUN: Saludar.
CHAMALL o KPAM: Indumentaria consistente originalmente en un tejido al Telar de lana de chileweke (llamo), después de lana de oveja, un paño rectangular sin costura que envuelve a la mujer que es similar a un vestido entero que cubre hasta más
abajo de la rodilla, lleva woltrhg (tejido fino de color vistoso como aplicación en todo el contorno).
CHAU: Padre, papá.
CHAUANTG: Padre Sol.
CHAWAI: Aro.
CHARHKI: Carne (preferentemente de caballo),
cocida con sal y aireada al humo.
CHADHI o CHAZI: Sal.
CHADILEGFG: Río de sal.
CHANGKO: Agua con forma de pierna.
CHAPD LEGFG: Río tipo charco.
CHAGTUN: Contradecir, discutir, oponerse.
CHAFN: Pelar, descascarar.
CHAELTUMAI: Muchas gracias.
CHAKAI: Carrumba, picapica.
CHALLWATUN: Comer o consumir pescado.
CHAKAI: Carrumba, picapica.
CHAF-FEI: Igualmente.
CHAFO: Resfriado con fiebre.
CHAKAIKO: Aguada de los chacales.
CHE: Persona, gente, ser humano.
CHE TRHUKN: Respetar como persona a otra, especialmente mayores, escucharle, apoyarlo en su petición, no desobedecerle, no insultarlo, ETC.
CHERHUFE O CHERHUBE: Ser turbio, Bola de fuego que emerge desde las alturas que se dejan ver y de acuerdo a la ubicación de su caída con sus energías absorbe personas que luego morirá, es decir, se distingue por anuncios negativos.
CHEMKN: Cosa, algo.
CHEUKE: Flamenco.
CHEUKETNG: Flamenco domado.
CHEUAM?: DONDE?
CHEMPIAM?: QUE DIJO.
CHEM PIMIAM?: QUE DIJISTE.
CHEM CHIAM?: QUE SERA.
CHUCHIAM?: CUÁL ES?
CHUCHI PLEAM?: POR DONDE.?
CHUMALAM?: Para qué.
CHLLFG LONGKO: Mente suelta.
CHPIL-LONGKO: Despeinado (a).
CHUMI CHIAM: Que le habrá sucedido.
CHINGAI: Fleco.
CHINGAN: Alimento obsequiado en una ceremonia y se guarda de vuelta a casa.
CHILKO: Planta medicinal, también se usa para
teñir, produce una flor de tono fucsia.
CHILLWE: Gaviota.
CHILEWEKE: Llamo.
CHILLANG: Encillar.
CHI:El, la.
CHORHI: Langosta.
CHOIKE: Avestrúz.
CHEUKE PANGUI: Avestruz puma.
CHOIKE PRHUN: Baile de Avestruz.
CHOMADO: Palo con fuego encendido.
CHORHI: Langosta.
DHAÑE: Nido.
DHAWE: Calabaza.
DHAPIN: Cuidar, proteger.
DHAFKAN: Picar o trabajar la Tierra con azadón.
DHAGLLI: Camarón.
DHNGUN: Hablar, conversar.
DHNGULN: Hablarle a alguien.
DHAWN: Hacer mal.
DHAF KALAN: No Cultivar la Tierra con azadón.
DHATUN: Ceremonia de tratamiento para la sanar enfermo, realizado por MACHI, con presencia de la familia y/o del LOFCHE (Comunidad) la participación y apoyo es colectivo. Esto es el mal llamado “Machitun”, que literalmente significa tomar la oel Machi. 
TUN: Significa tomar,agarrar, sujetar, comer; 
kofketun: comer pan.
chilkatun: estudiar.
Kdhautun: hacer un trabajo.
DHATUWE: Lugar apto para la realización de
Dhatun; ceremonia de sanación con Machi.
DHEA: Mujer joven, soltera, familiar o amiga de un varón.
DHEIU: Junto, en conjunto.
DHEIULN: Juntar.
DHEIUL-LAN: No juntar.
DHEU AMUN: Ya fui.
DHEUMAN: Hacer.
DHEUMALAN: No hacer.
DHEF: Lazo, cordel.
DHEGÑ: Volcán.
DHEA: Mujer soltera familiar por parte del varón.
DHEUMAKAN: Hechizo.
DHLLWI: Lombriz.
DHPILLWE: Instrumento de madera similar a un palillo que se usa para trabajar el telar.
DHENGLL: Poroto.
DHEGLLTUN: Comer, consumir porotos.
DHEGÑ: Volcán.
DHNGU: Tema, asunto.
DHEWG: Ratón.
DHIÑMA: Interesado.
DHIÑMA WENTRHU: Hombre interesado.
DHIÑMA GLCHA MALHEN: Joven mujer interesada.
DHNGUN: Hablar.
DHNGUI: Habló.
DHNGULAI: Él o ella no habló.
DHNGUMEAN: Iré a hablar.
DHNGUMELAIAN: No iré a hablar o a decir nada.
DHNGUPAN: Vine a hablar.
DHEWG: Ratón.
DHLLWI: Lombriz.
DHPILLWE: Especie de palillo de madera que sirve
para el trabajo más fino del telar.
DHIN: Alcanzar.
DHIULAN: No alcancé.
DHIUMEÑ: Abeja.
DHIMLLKO: Leña cortada en pequeño trozo, resto
de leña o madera.
DHOI: Mas.
DHOI MLEI: Hay más.
DHOMO: Femenino, hembra.
DHULLIN: Selecciona, elegir.
DHUMDHUM: Anochecer, Cambio de la claridad a
la oscuridad.
EIMI: Tú, segunda persona singular.
EIMU: Ustedes dos; dual, dualidad.
EIMN: Ustedes más de dos (tres o más).
ECHEL: Reserva de comida del día anterior.
ECHIU: Estornudar.
EKULL: Frazada, abrigo.
ELUWON: Ceremonia fúnebre, Funeral, la traducción textual significa preparación a una partida.
ELN: Dejar.
EL-AN: no dejar.
ELMEN: Fui a dejar.
ELMELAN: No fui a dejar.
ELIKURHA: Dejó piedra.
ELMEN: Fui a dejar.
ELMELAN: No fui a dejar.
ELUWON: Entierro.
ELTUN: Cementerio.
ELTUKAU: Cosas.
ELTUKAWE: Lugar de guardar cosas, objeto.
ELUFIÑ: Le di.
ELULAFIÑ: No le di.
ELFAL: Encargo.
ELUNGEN: Me dieron.
EPE: Casi.
EPE KPAI: Casi vino.
EPE KPALAI: Casi no vino.
EPE AMUI: Casi fue.
EPE AMULAI: Casi no fue.
EPE KELLUI: Casi ayudó
EPE IEMEI: Casi fue a buscar.
EPE IEMEN: Casi fui a buscar.
EPEU: Cuento, narración.
EPU: Dos.
EPEU: Cuento, narración.
EPUWE: Pasado mañana.
ELLKAWN: Esconderse.
EWAM: Arcada.
EPUMARHI: Veinte.
EPU WARHANKA: Doscientos.
EPUNAG: Dos veces.
EPU NGEIU: Somos dos.
EPULEF: Corriendo entre dos.
EPUNTUN: Nacimiento dobles o de Mellizo.
EPUEM: Eran dos.
EL-LAN: No dejar.
ELLKAN: Esconder.
ELLKAWN: Esconderse.
ELFALN: Encargar.
ELFAL: Embarazo.
EÑUM: Caliente.
EÑIMALN: Calentar.
ELLA: Más o menos.
ELLKAWI: Se escondió.
ELLKAULAI: No se escondió.
ELLAN: Discapacitado.
ELLAN NGELAI: No es discapacitado.
GHI: Nombre.
GHINGELAI: No tiene nombre.
GHITUN: Nombrar
GHI TUAM: Para nombrar.
GHIEU: Allá.
GHIEUPLE: Por allá.
GNGAPU: Bostezo.
GNGAPUN: Bostezar.
GL: Canto.
GLKATUN: Cantar.
GLCHA: Mujer joven, doncella.
GLMEN: Jefe máximo, poderoso, adinerado.
GNATUN: Morder.
GNAN: Mordisco.
GNAI: Picazón
GMAG: Sueño.
GMAGTUN: Dormir.
GMAG NAGN: Quedarse dormido.
GMAG TULAN: No dormí.
GMAG TUMEIU: Vamos a dormir los dos.
GMAG TUMEIÑ: Vamos a dormir todos, (más de dos).
GÑAM: Novio, pololo.
GÑM: Pájaro.
GÑI: Mutilla.
GMI: Pestaña.
GNUN: Mugre, suciedad.
GFL o PALI: Pelota de madera para jugar palín.
GHIEU: Allá.
GKL: Apretado.
GKLKLEI: Está apretado.
IÑCHE: Yo.
IÑCHU: Nosotros dos, dualidad.
IÑCHIÑ: Nosotros más de dos.
EIMI: Tú
EIMU: Ustedes dos
EIMN: Ustedes más de dos
KIDHU: él o ella
KIDHUIENGU: Ellas o ellos dos.
KIDHUIENGN: Ellas o ellos más de dos.
IÑCHIÑ MAPU: Nuestra tierra, somos tierra.
ILAN: No comí.
IN: Comer.
IEN: Llevar.
AFGTUN: Tomar energía, Nutrirse, tomar fuerza,
comer.
IAFGTUIU: Tomemos energía, comamos los dos.
IAFGTUIÑ: Tomemos energía todos, comamos.
IAN: Comeré.
INGE: Sírvete
IPEN: Estoy comiendo.
IPELAN: Yo no estoy comiendo.
IMEIU: Vamos los dos a comer.
IMEAIU: Nosotros dos vamos iremos a comer.
IAGUEL: Comida.
KANKATU: Asado a las brasas.
KANKATUN: Hacer asado.
ILHO: Carne.
ILHON: Carnear.
ILHOTUKELAN: No como carne.
ILHOTUN: Comer carne.
ILHOTUAN: Comeré carne.
ILHOKULLIÑ: Carne de vacuno.
AFN-ILO: Carne a la olla.
ILHO KORHG: Cazuela.
KORHG: Sopa.
MRHKE: Harina tostada.
MRHKE KORHG: Sopa de harina tostada con huevo,papas, sal y cilantro. Se consume de madrugada.
ÑACHI: Primera sangre del animal aliñada con verduras, ají, limón, se cuaja y se consume.
ÑACHITUN: Consumir Ñachi.
APOL: Pulmón del animal recién extraído, condimentado, relleno, pre-cocido, debe quedar al dente para consumirlo.
APOLTUN: Consumir apol.
KARHGTU: Pana recién extraída, picada, aliñada con
verduras y limón.
KARHGTUN: Comer, consumir karhgtu.
CHARHKI: Carne de caballo, cosida en sal, oreada
al humo.
PIDHKU: Especie de guiso hecha de diferentes cereales, legumbres, sin mayor condimento con químico.
AFNWA: Choclo cosido, se puede acompañar con carne u otro producto que se desee.
MANANGKU: Harina cocida con grasa, aliñado con cebolla picada fina, reemplaza el pan.
MILKAO: Es papa molida tipo puré que se mezcla con papa rayada seca, se amasa, se agrega harina, comúnmente se le da forma circular y se fríe, se recomienda servirlo recién hecho.
MLLOKIÑ: Cereal cosido molido, apanado, puede ser al natural como con sal y/o verduras, reemplaza el pan.
MLTRHN: También conocido por el nombre de Catuto. Se prepara de trigo cosido, molido apanado muy finamente, puede consumirse al natural .
KAKO: Es mote que puede ser de WA: Maíz,
KAWELLA: Cebada. 
KACHILLA: Trigo; Hervido, pelado con ceniza y se consume frío o caliente con sal o azúcar o al natural.
TKN: Es de trigo limpio partido semi-molido, similar al quaquer, que es para espesar sopa, guiso, con leche, ETC.
TIKN KORHG: Sopa de locro solo con papa y verdura o con cazuela de cerdo, pollo, ETC.
POÑI: Papa.
KOFN POÑI: Papa asada en ceniza o al rescoldo.
MALLUPOÑI: Papas cosidas.
CHELKO POÑI: Sopa a base de papas con
condimento.
KOFKE POÑI: Pan de papa.
KOIWE: Árbol nativo de hojas peremnes
FUNA POÑO: Chuño, papas puestas en humedad por un determinado tiempo.
RHNGO: Harina cruda.
FUÑFUÑ: Sopa con harina cruda refregada.
RHNGALTKU KOFKE: Tortilla al rescoldo.
IWIÑKOFKE: Sopaipilla, masa frita con grasa de caballo.
ZIMITA: Sopaipilla cocidas al agua, aliñado se consume con la sopa.
CHANGD O CHANGLE: Planta similar a los champiñones de color amarillo que sale en lo montes con abundancia de Tierra de hoja, el cual se sancocha y luego se hacen fritas con manteca, cebollas, huevo y aliños para servirlo con papas cocidas, pan o mllokiñ.
ÑENGM: Diweñe o llamado hongo por los occidentales; que es un fruto que produce el walle (roble) se pueden consumir como pebre con verduras o fritos con huevos y verduras.
IAFG: Duro.
IEN: Llevar.
ILHLU: Leche.
ILHUTUN: Tomar leche.
ILKA: Goloso.
INGKAN: Defender.
INGKAIAN: Defenderé.
ILWEN: Rocío.
ILLGNU: Atragantado.
ILLNGUN: Atragantar.
ILLKUN: Enojado.
ILLKULEI: Estar enojado.
ILLKULELAI: No estar enojado.
ILLKUTUN: Llamar la atención, retar.
INUF: Oler.
INUFTUN: Inhalar.
ILLAM: Desprecio.
ILLAMTUN: Despreciar.
ILLAMKANGEN: Me despreciaron.
ITRHO: Directo, recto, derecho.
IEWEN: Vergüenza.
IKLLA: Reboso, echarpe, chal.
INAN: Menor.
INALTU: A la orilla.
INAKAN: Investigar.
INANTKUN: Perseguir.
INALEF: Perseguir con velocidad.
IWE: Plato.
KA: Otro.
KA: Y, depende del contexto.
KACHAÑA: Loro.
KACHILLA: Trigo
KAIU: Seis.
KACHUTUN: Pastar.
KACHUWE: Lugar pastoso.
KALEI: Distinto, diferente.
KA KIÑE: Una más, otra.
KACHU: Hierba, pasto.
KATRHN: pedazo, una parte.
KALKU: Brujo.
KALKUTUN: Hacer brujería.
KAKL: Atravesado.
KAPRHA: Chivo.
KAL-LCHE: CUERPO HUMANO (Aquí va una hoja,
partes del cuerpo humano.
KANGKAN: Asado.
KALLFN: Color
KALLFG: Azul.
KARHKARH: Jazpiado.
KELG: Rojo.
KOLG: Café.
KOÑOL: Morado.
LIG: Blanco.
KARHG: Verde
KURHG: Negro.
CHOD: Amarillo.
PAINE: Celeste.
KALLFGWENU: Cielo.
KUWG: Mano.
KLKAI: Collar.
KALHLCHE: Cuerpo humano.
KATAN: Perforar
KATAN PILUN: Perforar oreja.
KARHA: Pueblo.
KG-LA: Número tres.
KOLIWE O KG-LA: Coligüe, Arbusto que palos finos muy preciado para la construcción de los techos y paredes de la rhuka.
KILANTU: Monte de coliwe.
KG-LAKOIAM: Tres montes.
KG-LA WEZKE: Tres contras
KELLM O KELIN: Enrojecido.
KILLAI: Árbol que crece muy alto que se uso ancestralmente como champú o detergente a su vez es medicinal.
KINCHAMALI: Hierba medicinal que crece en las alturas, especialmente indicado para el resfriado.
KIMN: Sabiduría, conocimiento.
KIMCHE: Gente Sabia.
KIMNCHE: Conocimiento de la gente.
KIMN MAPU: Sabiduría de la gente de la Tierra.
KREHF: Viento.
KRHEFLAI: No hay viento.
KO: Agua.
KODKILLARAIEN: Copihue, flor nativa.
KOÑIN: Parir.
KOÑIÑ/CHOIUN: NACIMIENTO MAPUCHE.
KOM: Todos.
KON: Identificación al jugador que hace de contraparte en el palin y se le atiende de lo mejor.
KONN: Entrar.
KONKON: Ave que hace anuncios negativos.
KÜLFUN: Agil, alentado.
KÜIEN: Luna, día.
KURHEIEWN: Casarse.
KONCHOTUN: Hacerse compadre, sellar amistad.
KOIAUTUN: Pronunciar discurso.
KATRHGWALA: Pato cortado.
KÜLKO: Chaiwe, envase amplio de mimbre,
especialmente para lavar mote, hecho de Foki.
KOCHIKURHA: Azúcar.
KOIAM: Roble.
KULLIÑ: Animal.
KULLITUN: Pagar.
KUIFI ZOMO: Antigua valiosa Mujer Mapuche.
KULLIN: Dinero.
KUNL: Familia.
KURHEWEN: Matrimonio, cónyuge
FGTA: Esposo.
KURHE: Esposa.
KRHUN: Cuñado (A), esposo de la hermana por
parte de la mujer.
FILLKA: Cuñado (a)
ÑADHU: Cuñada entre mujeres por parte del
hermano.
NGILLAÑCHE: Entre consuegros.
ÑUKE: Madre.
IALL: Hijo (a) del padre.
KOÑI: Hijo (a) por parte de la madre.
KOÑINTU: Sobrino (a) hijo de la hermana de la
mamá.
CHAU: Padre.
MALLE CHAU: Tío por parte del hermano del padre
MALLECHAU: Tío por parte del hermano del papá.
ÑUKENTU: Tía materna, hermana del papá.
FOTM: Hijo varón por parte del padre.
ÑAWE: Hija por parte del padre.
NGILLAÑ: Esposo de la hermana del varón.
ÑEÑE ÑUKE: Madrastra.
PÑMO: Esposa del hijo.
RHEÑMA: Legítimo.
PIUKE: Corazón.
PIUKEWEN: Entre familia
LLALLA: Suegra.
CHEDHKUI: Suegro, el padre de la esposa.
CHEDHKUIWEN: denominación entre suegro y yerno.
ÑOÑO: Bis abuelo, padre o madre de los abuelos.
KTIL: Loco, desordenado.
KULLKULL: Instrumento de viento, hecho de hasta de vacuno que emiten sonidos de llamado,usado sólo por varones.
KURHA: Piedra. 
KURHGLEMU: Monte negro o monte oscuro.
KURHA MAÑKE: Cóndor de Piedra.
KURHA MILLA: Piedra Dorada
KURHA PANGUI: Puma de piedra.
KURHA MALAL: Corral de piedra.
KURHG PULLI: Tierra oscura.
KURHG ñAMKU: Águila Negra. Padre de Lautaro y nombre de otro gran cacique del siglo XVIII.
LA: Muerto.
LAN: Morir.
LAI: Murió
LACHE: Cadáver, Persona muerta.
LALAI: No murió.
LANTU: Viudo, viuda.
LAFKEN: Mar.
LAFKENCHE: Gente del mar o del Oeste.
LAFKENMAPU: Tierra del mar.
LAKUTUN: Ceremonia de celebración y presentación.
KACHU LAWEN: Hierbas medicinales.
MAPU LAWEN: Medicina de la Tierra.
LHAFTRHA: Chico, enano.
LEMU: Monte, bosque.
LEMUNTU: Montaña.
LEPN: Barrer
LEF: Rápido, veloz. Carrera.
LIG: Blanco.
LIF: Limpio.
LELPE: En breve, pronto, rapidito.
LELFNCHE: Gente del campo.
LIPOMN: Limpiar.
LILA: Patio. LILA MEU: En el patio
LINGARH: Blanqueado.
LINCHU: Linaza.
LIKAN: Poder.
LIKANKURHA: Piedra poderosa.
LIKAN ANTG: Astro sol poderoso.
LONGKO: Jefe o cabeza, depende del contexto.
LOLO: Hoyo.
LOFCHE: Comunidad, es la segunda unidad esencial de existencia entre parentesco después del KUNL (familia) que conforman lo que actualmente se llama reducción.
LONGKOPANGUI: Cabeza de puma.
LONKOMILLA: Cabeza dorada o de oro.
LPMN: Quemar.
LFN: Quemarse.
LF: Quemado.
LPI: Pluma.
LPIMAÑKE: Pluma de cóndor.
LLAG: Un poco.
LLAGN: Ofrecer o compartir alimento con otro.
LLAKO: Tibio.
LLAKOKO: Agua tibia.
LLAMGKO: Valle.
LLAI: Alejarse solo.
LLALLIÑ: Araña.
LLAPD: Escarcha.
LLEPEIÑ: Hormiga.
LLEPG: Bandeja redonda, grande, de mimbre, se usa para ventear cereales, trigo, maíz, ETC.
DHULLIÑMAWIDHA: Monte escogido o predilecto.
DHKEKO: Un jeme (medida de hondura) del agua. Río que con el Laja configuran lo que se denomina Isla del Laja en la Frontera. Nace del volcán Antuco y desemboca por la ribera norte del BíoBío.
DHKIWALA: Pato atascado.
ELIKURHA: Dejó Piedra, Nombre de un cacique contemporáneo de Lautaro y que le da nombre al paraje donde vivió, los valles de la cordillera de Nahuelbuta que bajan hasta el lago Lanalhue.
IKALMA: La Encajada. Laguna de la cordillera de Lonquimay, “encajada” en sus estribaciones. Una de las fuentes del Bío-Bío y próxima a ella se encuentra un paso andino muy frecuentado por su baja altura.
ITATA: Donde abunda el pastoreo. Río importante que nace en Los Andes y que con curso oeste traviesa las serranías de Cholguán entre densas selvas, para ya en el valle recibir el tributo del río Ñuble. Desemboca en el Pacífico en el lugar denominado Punta Coico, donde se forman las conocidas Vegas de Itata.
IFMTU: Aves, animales en general.
LANALWE: Alma muerta. LAPELAPE: Grito de guerra de los mapuches. ¡A muerte! (Lape es muerte; la repetición de la palabra indica idea de intensidad, abundancia o agrupamiento).
LARHKETRHE O LARAQUETE: Barranca en forma de mentón.Cerro de mediana altura que se desprende del cordón central de la cordillera de Nahuelbuta y avanza hacia el mar, cortándose en su orilla de forma abrupta. 
LEFTRHARHU (Lautaro): Aguila Veloz. (Ver traro)
LEMULEMU: Bosque Frondoso.
LEMUNAG: Abajo en el monte.
LEMULLANKA: Piedrecillas del bosque.
LIENTUR O LIG-EMTUHRPU: Exactamente todo blanco (Lig-emturrh) Blanco en la totalidad.
LILPGLLI: Loma de los riscos.
LIGMAI: Emblanquecido.
LIGKOM: Todo blanco.
LIGKOPANGI: Agua cristalina del sol.
LIGKOIAM: Roble blanco. Nombre de un jefe militar aliado de Lautaro.
LINGUE o LIGNGE: Uno de los arboles más característico de los bosques mapuches. Se alza casi a la altura de los coyanes (veinticinco - treinta metros). 
LGPINAGMEU: Plumas abajo.
LOFNOPAN: Venir del otro extremo del LOF o comunidad.
LONGKOPANGI: Cabeza de puma.
LONGKOTURH: Gran jefe.
LONGKO: Cabeza, y figurado, jefe.
LONKIMAI: Efectivamente parece jefe. Volcán de la cordillera de Los Andes, al oeste del curso superior del BíoBío, vecino (al sur) del volcán Tolhuaca.
LUAN: Guanaco.
LUMA: Árbol mirtáceo de madera dura y resistente a la humedad. Con su madera se confeccionaban utensilios como platos, cucharas, cachiporras mazos de guerra, arados rudimentarios, etc.
LUMAKO: Aguada de las lumas.Paraje pantanoso en las faldas orientales del Nahuelbuta, próximo a la cuesta de Purén.
LLAIMA:desaguaderom valle. Volcán de la cordillera de Los Andes coronado por nieves eternas que se distinguen desde largas distancias. 
LLAMGKO: Valle.
LLANKA: De llanca: piedrecitas azul verdosa que se utilizaban de adornos.
LLANKAN: Denominación de la asistente del o de la Machi.
LLANK-LEN: Estoy caído, sólo, o suelto.
LLÑKINAWEL: Tigre rana
LLANTEN: Hierba de hojas dentadas y de nervios muy marcados. Es medicinal y se usa principalmente para cicatrizar heridas, y como infusión, para ulceras.
MAKANA: Mazo de guerra grueso en su parte activa y fino en la empuñadura para asirlo con una sola mano, midiendo alrededor de un metro y construido con madera muy densa, generalmente con luma. Los registros de su uso lo datan sólo para el siglo XVI.
MACHI: Médico, muy brevemente lo podemos definir como Terapeuta familiar, que son principalmente mujeres que son absorbidas por las antiguas energías positivas y negativas.
DHATUN:ceremonia de tratamiento de sanación a cargo del o de la MACHI.
MAICHIN: Llamado con seña con la mano.
MAITEN: Árbol de uso medicinal.
MAITENRHEWE: Rhewe de maiten.
MAKUÑ: Manta, hecho en telar con diferentes diseños propios, para niños, adultos, Longko, que usan los hombres Mapuche (s).
MALHEN: Mujer
MALLE: Tío carnal. Apelativo de los niños a sus mayores. Trato afectuoso entre adultos
MALLEKO: Malle deformado de mallo, greda blanca.
MALLIN: Aguazal, bajos aguachentos. Por extensión se denominan así las plantas que crecen en ese.
MALON: Podía ser cualquier tipo de violencia, y entre los más comunes estaba el robo y el compromiso incumplido, o un pretendido insulto;
también debe considerarse la invasión de territorios de caza ajenos. 
MALIKEO: Donde se origina el deseo negativo.
MAMÜLLMAPU: Tierra Arbolada. Tierra de las Leñas.
MNULWE o MNUWE: Adornos fantásticos que llevaban antiguos guerreros en la cabeza; penachos de plumas y más frecuentemente cabezas de animales (zorros, gatos monteses, etc.). También se utilizaba en fiestas.
MANGILWENU: Cielo que anuncia la subida de ríos.
MAÑIO: Conífera siempre verde y de ramas muy tupidas. Su madera se utiliza para la construcción y mueblería.
MAÑKE: Cóndor.
MANKEL: Nombre ancestral que significa para dar un punta píe.
MAÑKELPI O MAÑKELIPI: Pluma de Cóndor
MAPOCHO: De mapu - ch (e-c) o. Río de los mapuche(s)
MAPU: Tierra, país, patria.
MAPUDNGUN: Lengua, habla o hablar de la tierra.
MARHICHIWEU: Es una frase emblemática que significa diez veces venceremos.
MARHIWALL o  MARIHUAL: Diez vueltas alrededor.
MARHILUAN: Diez Huanacos.
MARHIPI: Diez veces dijo.
MARHIPOWAL: Faltan diez para llegar.
MARHIFILU O MARHIVILU: Diez serpientes.
MARHA: Liebre.
MARHI: Diez, 10
MARHILUAN: Diez guanacos.
MARHILLANGKA: Diez piedras preciosas
MARHIPILLANG: Diez volcanes.
MELIPGLLI O MELIPULLI: Cuatro cerros. Nombre dado a la rada de Puerto Montt.
MEDHKEN O MEZKN: moler.
MICHIMALONKO: MINCHE-EMALL-LONGKO= Toki que vivía en el Alto Aconcagua y desde la llegada de Valdivia al Mapocho, actuó como un gran agitador de un levantamiento general de Mapuche (s) en ambos valles. En 1547 es sometido y va en la expedición colonizadora de Valdivia como capitán de los (indios-amigos), participando en las batallas de Andalién y Penco. Vuelve a Santiago donde al poco tiempo pretende rebelarse nuevamente y es ahorcado.
MICHIZ: Arbusto espinoso: Hojas y frutos se utilizan en infusión para inflamaciones; la corteza y raíz,para tinciones de amarillos.
MELILAFKEN: Cuatro mares.
MILLAKEUPU: Puente de oro.
MILLARHAIEN: Flor de Oro
MILLATRHAI: Cascada de Oro
MININKO: Agua para el baño. Balneario
MONGEN: Vida.
MOLUCHE: Gente de guerra.
MULCHEN O MOLUCHEN: Preparar gente para la guerra.Gente del oeste.
MUDHAI: Bebida preparada a temperatura muy
bien calculada ni hervida ni sin hervir con agua
cristalina de vertiente y cereales como. Arvejas,
abas, papas, Zawe; Kinoa, kimwa, cebada, trigo, que
no se fermentan a diferencia de las frutas que sí se
fermenta lo que se conoce como Chicha.
NAF: Húmedo.
NAGN: Bajar.
NAGPAN: Vengo bajando.
NALKA: Fruto silvestre, que contiene vitamina C.
NALKATUN: Comer nalga.
NAMUN: Píe.
NANNG: Yerna.
NAPURH: Verdura silvestre que se consume en
guiso o ensalada cocida.
NAPURHTUKEN: Consumo naporh.
NAPURHTUKELAN: Yo no consumo naporh.
NAWEL: Tigre.
NAWELWAPI: La Isla del Tigre.
NAWELFGTA: El Gran Tigre.
NEIN: Respiro.
NEGUMN: Moverse.
NERHM: PULGA.
NEWEN: Fuerza.
NIEN: Tener.
NIELAN: No tengo.
NIEIU: Nosotros dos tenemos.
NIELAIU: Nosotros dos no tenemos.
NIEKEIU: Nosotros dos teníamos.
NIEKELAIU: Nosotros dos no teníamos.
NIEPÑEÑ: Embarazo.
NIEPÑEÑLKEI: Está embarazada.
NHIN: Temblor.
NOMETU: Al otro lado del río, al frente o al otro
lado.
NON: Pasar al otro lado del río, pasar al frente.
NOTUKAN: Insultar, agredir.
NGMG: Fétido, mal olor.
Ngapitun: Casamiento ancestral propio Mapuche,
ceremonia en que la pareja de novios Mapuche,
inician la unión primero con el rapto por el novio y
su werhken: mensajero comunican a los padres para
luego de acuerdo a la recepción de los padres de
la novia se hace una gran fiesta, en que participan
familiares y los lofche (s) involucrados.
NGADHU: Fruto silvestre, como papa blanca, se
consume la raíz de color blanco transparente dulce,
posee vitamina C.
NGAN: Siembra o sembrado.
NGANN: Sembrar.
NGMAN: Llorar.
NGMAFE: Persona llorona.
NGE: Ojo.
NGEMEN: Fui.
NGEPAN: Vine (acá)
NGEFGÑ: Avellano.
NGRHEN: Telar, tejido.
NGRHEKAFE: Tejedora.
NGEN: Dueño, propietario.
NGENMAPU: Ser poderoso invisible dueño de
algunas extensiones de Tierra, que los seres
humanos no deben trasgredir, se debe respetar
de lo contrario se suceden graves consecuencias,
pedir autorización para pasar o entrar, es parte de
costumbre Mapuche.
NGEDHUN: Arrancar una planta con raíz.
NGEDHUKAN: Exterminar las planta con raíces y
todo.
NGIDHFKAN: Coser, costurar.
NGILLATUFE: Persona que hace ceremonia.
NGIDHOL: Jefe, autoridad, la primera
persona a cargo, raíz más firme.
NGRHEKAN: Es el arte de telar o tejer.
NGRHEKAFE: Tejedor, tejedora.
NGEIKURHEWEN: Ceremonia propia de los o las
MACHI, cada cierto tiempo renuevan, refuerzan su
NEWEN, su espíritu, sus poderes, sus conocimiento
en compañía de su Lofche.
NGILAWE: Bao, paso donde se puede atravesar un
río.
NGILLATUWE: Lugar especial elegido protegido
donde se realiza la ceremonia principal de
demostración de la fe.
NGILLATUN: Principal ceremonia colectiva
Mapuche en que comparte directamente con las
energías positivas y negativas del Universo, dirigido
por Machi, Longko, Kimche,
NGILLATUFE: Personas que participa en la rogativa.
NGILLAÑMAWN: religión, expresión de
demostración de la fe.
NGILLAKAN: Comprar o cambiar alguna especie
por dinero.
NGILLAMEN: Fui a comprar.
NGILLAKAFE: Comprador, comerciante.
NGOIMAN: Olvidar.
NGOLLIN: Embriagado, borracho.
ÑAMKU O ÑAMCU: Aguila
ÑAMKUCHEO: Águila con características de persona.
ÑADHU: Cuñada entre mujeres.
ÑAWE: Hija por parte del padre.
ÑAM: Perdido.
ÑAÑA: Hermana, amiga se refiere a una mujer.
ÑAÑAI: Señorita, mujer soltera.
ÑAIKI: Gato
ñENGM: Dihueñe u hongo como se llama en
wingkadngun.
ÑIWIÑ: Cosechar, machacar las espigas con los pies.
ÑIMÑIM: Calambre.
ÑOA: Astuto, pícaro.
ÑOCHI: Lento, despacio.
ÑOCHA: Amarra, cordel.
ÑOLKIÑ: Instrumento de viento, largo de madera.
ÑOM: Manso, domado.
ÑUKE: Madre, mamá.
ÑUKE MAPU: Madre Tierra, es un gran concepto de
principio básico Mapuche, puesto que la Tierra no
es un simple bien comercial como lo conciben los
no Mapuche porque la Tierra no se puede vender
ni regalar ni prestar puesto que es la base principal
de sustento y existencia como seres vivos Mapuche
que emergen de la Tierra. Y al morir los Mapuche
(s) regresan al vientre de la Ñuke Mapu para volver
a nutrirla.
ÑUKENTU: Tía, es por parte de la hermana de la
mamá.
NEUKEN O NEUQUEN: traspasar barreras.
NIILTUKEN: Una brazada (medida de hondura) de
agua. Río Laja que desemboca al BíoBío más abajo
que el DHUKEKO.
ÑIRHI: Árbol o arbusto de corteza lisa y lustrosa
y de flores de pétalos anchos, suaves y casi
transparentes. Crece a orillas de ríos y esteros.
OFL: Sorbo.
OFLN: Bocarada.
OLN: Dar.
OL-LAN: No dar
OÑON: Devolverse
OTUN: Visitar
OTRHIN: Mirada.
OTRHIN TUN: MIRAR.
OTRHIN TULAN: No mirar (primera persona; yo no
miro).
OTRH-N: Enristrar cebolla, ají.
OTRHO KON: Regar.
OTRHO KAN: Picar porotos verdes para guiso o
ensalada.
PAIKO: Hierba medicinal.
PALI: Pelota pequeña de madera en que se juega palin.
PALIN: Deporte que juegan sólo los varones, para
mostrar resistencia, técnica es más de encuentro
que de competencia ya que se complementa
con una ceremonia de convivencia, llamado
comúnmente como Chueca, porque el instrumento
que se práctica el juego es un palo de un metro y 20
CMS. Con una punta vuelta.
PALLU: Araña con pinta roja, venenosa.
AZENTU; PALIFE PCHI RHñIKO TUWI.
PALIFE: Jugador del palin.
PALIKAFE: Jugadores del palin.
PALKURHA: Bola de piedra para jugar palín
PALIMEIÑ: Vamos a jugar el deporte palin.
PALIKATUN: Ejercitar, jugar el deporte Palin.
PAKARHWA: Sapo.
PAMPDHKEN: Mariposa.
PAPAI: Señora.
PANGI: Puma.
PANGILEF: Puma veloz.
PALNG: Palote.
PANGKLL: Puma cachorro.
PAPAIKAFI: También es mujer adulta.
PAIKAFI: Nombre del Cacique contemporáneo
de Leftrharhu (Lautaro) y nombre del río que desemboca en el lago LAN-ALWE (Lanalhue).
PAILA: De cubito dorsal.
PEÑI: Herman o entre hombres.
PEKAF: Parte de una madera quebrado.
PEUKALLAEL: despedida, chao, que significa; Hasta
pronto,
PEL: Cuello.
PELEKO: Agua de barro
PELE: polvo, tierra suelta.
PEN: Ver.
PEDHAN: Encontrar, algo lindo caído del cielo.
PELLKE: Miedoso.
PILALAWALA: Pato Reposado.
PAILAWEKE: Guanaco despalda.
PAINE: Color celeste.
PAINE NGRH. Zorro celeste, grisáceo.
PAINEMAÑKE: Cóndor celeste, grisáceo.
PAINE MILLA: Oro de color celeste
PANGI: Asoleado.
PANGIANTG: Día asoleado.
PANGUI O PANGI: Puma, león.
PAIUN: Bigote
PEKARH: Es algo manchado.
PEUMO: Árbol nativo frutal y medicinal
PEWEN: El árbol más alto que se produce en
PEWENMAPU, mal conocido como Araucaria y su
fruto se llama NGLLIU= Piñon.
PELANTRARHU O PELANTARU: Es no encontrar el
águila.
PEMEWE: Lugar del cual se mira. Mirador.
PEMOLLENKO: Aguada del moscardón azul.
PENKO: Encontrar agua.
PERHKENKO: Lugar dónde se encontró agua.
PCHIN: Poco.
PCHICHE: Niño o niña.
PCHICHEN: Niñez, época de infancia.
PCHITRHARHU: Águila pequeño.
PICHIMAÑKE: Cóndor pequeño.
PIKUMLEGFG O PICUNLEUFU: Río del norte.
PIFLLKA: Instrumento musical de viento.
PINDHA: Picaflor.
PINGDHA: Murciélago.
PILLAN LELFN: Campo de espíritus.
PGLLIAM, Püllü, PILLANG O PILLAN: Volcán, que
tiene movimiento, vida, tiene energía, poder, con
espíritus especiales. Estado final que alcanza el
espíritu de un miembro fallecido, después de un
largo camino.
PILLOWE: Vara de madera pesada o densa con una
punta aguzada en un extremo. Con ella se hacen los
agujeros donde se siembran las simientes.
PIN: Decir.
PILAN: No quiero.
PILIÑ: Nieve, escarcha.
PIRHKEN: Dije así antes.
PIRHE: Hielo, graniso, volcan.
PIRHU: Gusano.
PITRHUFKEN: Dónde caen las cenizas.
PIUKEWEN CHE: Personas entre familia
POIEN: Estimar, amar, querer.
PODH: Basura, mugre.
PUDHU O PUDU: Ciervo chileno (es enano: su
cabeza alcanza los 50 centímetros de altura).
PUCHAKAI: Dentro de la picapica, entre chacayes
(arbusto).
PUKEM: Invierno.
PURHA: Ocho.
PURHAMARHI: Ochenta.
PURHAPATAKA: Ochocientos.
PURHAKAWIÑ: Diez fiestas.
PORHEN O PUREN: Podría ser dentro del Rhenü
que le da nombre a la región situada en las faldas
orientales del Nahuelbuta a 65 kilómetros de
la actual ciudad de Angol. 
PU: Dentro, depende del contexto que se trate
significa, los las, es decir, pluraliza.
PURHAN: Dentro de la plata, dentro del metal.
PÑEÑ: Guagua, hijo o hija.
PÑPÑEL: adorno que cuelga del TRHAPEL: Pectoral
de plata que usan las mujeres o adornos que cuelgan
de los collares.
PRHAN: Subir.
PTRHARH: Piejo de la ropa.
PRHON: Nudo.
RHAIEN: Flor.
RHAG: greda.
RHAKIÑ: Contar.
RHAKIU: Contemos nosostros dos: Kiñe:1, Epu: 2,
KG-la: 3, Meli: 4, Kechu:5, Kaiu:6, Rhelnge – relgue o
rhegle: 7, Purha: 8, Ailla: 9, Marhi: 10,
Marhikiñe:11.
RHAKIFIÑE: Cuéntalos tú.
RHANKIL: Carrizo, pajonal.
RHAKIFE: Contador.
RHANGKL KO O RNAKILCO: Canasto, chaiwe de
plata.
RHALI: Plato.
RHAKIDHUAM: Pensamiento, ideas.
RHAMTUN: Preguntar.
RHAMTUFE: Investigador, preguntón.
RHARHAL: arbusto de uso medicinal.
RHAWIÑMA: Loro.
RHAKMTKU: Encerrar.
RHNGALKO O RALKO: Agua subterránea.
RHE: Puro, sólo.
RHEKG: Mezquino.
RHEKFE: Persona que mezquina.
RHEÑMA: Legítimo.
RHEPG: Camino.
RHELMU: Arco iris.
RHEGN: Servir con cucharón.
RHELNGE: Número siete.
RHEWE: Lugar puro. Espacio consagrado y de uso
exclusivo para las actividades espirituales de la
comunidad; en particular es donde se desarrolla
el NGILLATUN, rogativa para que el Espíritu les
sea propicio al colectivo en las actividades que
enfrentan: cosechas, viajes, pestes, guerras, o
grandes partidas de caza (boleadas) de las cuales
dependía la existencias de buena vida para todos
los seres vivos.
RHELMUANTG: Arco iris de día.
RHINGKN: Saltar.
RMEWEIKO O REMEWEIKO: Valle de cunquillos.
RHNGAIKO: Agua sacada del subterráneo.
RHANGILEGFG: En medio del río.
RHEPGKURHA O REPGKURHA: Camino de piedra.
Sitio ubicado sobre el río CholChol, al oeste de
Purén.
RHUKATUFE: Constructor de casa.
RHUKA: Casa. 
RHUKA KAWIÑ: Reunión de familiares y vecinos se
reúnen para celebrar la construcción de la rhuka.
El dueño al terminar la obra, festeja la ayuda con
una fiesta de mucho mudhai y abundante comida.
Es un importante mecanismo de cohesión social del
rehue.
RHUKA CHOROI: Morada de los loros.
RHUKAKURHA: Casa de piedra.
RHUKALWE: Lugar donde es posible construir casa.
RHUPAN: Pasar acá.
RHUMEN: Pasar hacia allá.
RHUMEI: Pasó al otro lado.
RHUFENKO: Agua turbia.
RHUNA: Puñado.
RHUMEL MONGELEAIÑ: Por siempre viviremos.
TAPL: Hoja.
TAKUN: Tapar.
TAI: Hace un rato, Denante.
TAÑI: Mí de mío.
TAIÑ: Nuestro.
TAIÑ ADHKPA: Nuestro ancestro.
TAIÑ ADHKPA KIMN: Nuestro conocimiento ancestral.
TEMU: Árbol llamado temu.
TEWELCHE: Designación específica de los mapuches al pueblo viviendo en la Pampa y que poseían
una lengua común.
TEPA: Árbol alto de la familia del laurel, su madera
es preciada aunque despide un mal olor.
TNGHINK O TINGUIRIRICA: Seres mitológicos;
enanos guerreros que utilizaban flechas de oro,
por lo cual, los españoles gustosos ofrendaban sus
pechos para ser atravesados por ellas. (in: A Sangre
y Lanza)
TIEMEU: Por allí.
TIEPLE: Por allá.
TIMUN: Arado.
TKUN: Sembrar.
TKUPEN: Estoy sembrando.
TKUMEAN: Iré a sembrar.
TKUMELAIAN: No iré a sembrar.
TILTIL: Gota a gota.
TILTILKO: Agua a gotera.
TOL: Frente.
TOLWAKA: Testa de vaca.
TOLPANGI O TOLPAN: Testa de león
TOLTEN: Canto del Trhegl. Según Moesbach, es una
voz onomatopéyica que pretende reproducir ruido
de aguas.
TONOWE: Especie o similar a un palillo de madera
que se usa para el tejido del Telar.
TOPEL: Nuca.
TOKI: Hacha.
TOKI: Jefe de guerra en período de guerra.
TOKI: De trhokiñ dirigir las partes, distribuir: El que
distribuye y manda. Concepto que se materializa en
el hacha, la que divide por autoridad.
TOKIKURHA: Hacha de piedra.
TUI: tomar, tocar.
TUN: Tomar, sujetar.
TUKAPEL: Adueñarse desde el cuello a viva fuerza
de lo observado. 
TUMEN: Ir a sujetar, a cazar o cortar o sacar algo.
TUMELAI: El o ella no fue a cazar o sujetar algo.
TUIÑMALHEN: Mujer encantada del río.
TURHPU: Preciso, justo.
TRHANALEI: Está botado.
TRHANALELAI: No está botado.
TRHANAN: Machacado.
TRHALKA: Arma de fuego.
TRHALKATUN: Disparar.
TRHALKAN: Trueno.
TRHRHUAM O TIRUA: Cuartel. Lugar de
concentración de mocetones para la guerra.
TRHAIENKO O TRAIGUIEN: Ruido de cascadas.
TRHALKAWENU O TALCAHUANO: Trueno, Cielo
Tronador.
TRHAPEL: Pectoral de plata que usan las mujeres
Mapuche.
TRHAPI: Ají.
TRHAPOMN: Juntar.
TRHARHIKAN: Laboreado.
TRHARHIKAN MAKUÑ: Manta principal de los
longko(s) que llevan diseños especiales.
TRHARHILONGKO: Corona de plata que usan las
mujeres para concentrar sus pensamientos y sirve
de adorno que se usa en las principales ceremonias.
TRHARHI LONGKO: Faja que usan los hombres hecho
de telar, de paño o cuero, anudado alrededor de la
frente para concentrar las ideas o que sujetar el cabello,
o como distintivo del werhken (siempre color rojo).
TRHARHU: Rapaz blanquecina con manchas negras;
los bordes de las alas y la punta de la cola son negros;
lleva en la cabeza una especie de corona de plumas
negras y las patas son amarillas y escamosas.
TRHEMKE LAFKEN O TRENKE LAUKEN: Crecida
del mar.
TRHEMTRHEM O TRENTREN: Nombre de un
cerro que se elevaba hasta tocar el cielo en
los maremotos. Era regido por una serpiente
mitológica TRHEMTRHEMFILU (Trentrenvilu), que
protegió a los hombres de un gran diluvio causado
por KARHKARHFILU (Caicaivilu). Mientras las aguas
subían, TRHEMTRHEMFILU elevó la montaña donde
los hombres se protegieron de morir ahogados.
TRHEKAN: Caminar.
TRHEMN: Crecer.
TRHEMAIÑ: Creceremos.
TRHEPEN: Despertar.
TRHEPEIÑ: Despertemos.
TRHELKN: Erupto.
TRHEFAIK-LEN: Alacrán.
TRHOMEN: Día nublado, Lugar sombrío.
Valle ubicado en la novena región al este de Purén,
entre esa localidad y Quechereguas.
TRHOMPE/PAUPAWEN: Instrumento de percusión que lo tocan hombres y mujeres.
TRHUFTRHUF: Fermento, ebullición de un líquido. 
TRHUMAO: Tierra de arenisca delgada y volátil.
TRHUTRHUKA: Instrumento de viento constituido por una caña hueca, variando entre los dos y seis
metros de largo; por un extremo se le aplica una boquilla de hueso, y en el otro, una caja de resonancia del mismo material, pudiendo ser un cuerno de vaca. Se toca de pie precisando de buenos pulmones y sus dos únicas notas son graves, lúgubres, y se escuchan a gran distancia.
TRHOLTRHO: Espina, cardo
TRHOLTRHONTU: Espinal.
TRHLA: Garza.
UIA: Ayer.
UMAÑ: Añejo, de antes.
ÚLMEN O MAS BIEN GLMEN: Persona con muchos bienes materiales, un hombre rico. Otra acepción es la de un hombre ponderado y sabio, cuya voz es escuchada con atención y deferencia. Es un hombre influyente, un Gran Hombre.
UKAN: Rebanada, pedazo.
UKAN KOFKE: Pedazo de pan.
ULPO: Harina tostada preparada con agua hervida
con KOCHIHRHA. Azúcar.
UMITA: Crema de maíz tierno molido con especies, 
UIAKONA o YANAKONA: Traidor que sirvió en favor
de la fuerza militar o auxiliar de los conquistadores.
WA: Maíz.
WAI: Rayo.
CHIWAI ANTG: Rayo de sol.
WALLE: Roble.
WAILLE: Hipomorfosico, fuera de lo normal.
WANGLEN: Estrella.
WAIKI: Lanza.
WAIKILEF: Lanza veloz.
WANGKN: Ladrar.
WANGKU: Asiento.
WANGKFE: Ladrador.
WE: Nuevo.
WE: Cuando en la terminación de una palabra
significa lugar donde abunda algo.
WEDHWEDH: Desordenado.
WEFI: Germinó.
WELAFKEN: Mar nuevo.
WELU: Pero.
WENU: Arriba, sobre.
WENUFOIE: Bandera
El wenufoie es un símbolo que representa que
une y no divide, sino que exterioriza la presencia
mapuche, su identidad, historia, cultura, derechos.
Es una muestra más de la diversidad que caracteriza
este país que se tiene que respetar; es el llamado al
diálogo entre civilizaciones y culturas, al respeto y a
la comprensión mutua entre los pueblos.
WERHKEN: Mensajero.
WENTRHU: Hombre, masculino, macho.
WEWün: Ganar.
WILI: Uña.
WILINAMUN: Uña de los pies.
WILIKUWG: Uña de las manos.
WILKI: Zorzal.
WILPRH: Labios.
WIM: Habituado, acostumbrado.
WIMLAI: No se acostumbra.
WIÑOL o WOÑOL TRHIPANTU: Retorno de la salida del Sol renovado, Año nuevo Mapuche.
WILLICHE: Gente ubicada en el sur Chile.
WITRHAL: s todo lo que compone el tejido del telar.
El WITRHAL, tiene varias partes de distintas
que cumplen diferentes funciones. Lleva:
KLOU, tonon, tonote, witrhalwe, dhpillwe, fghu,
rhangiñelwe,ngrhewe,
WON: Boca
ALLOF PGTRHA: Guata hinchada.
ANKACHOIN: Aborto, nacimiento anormal.
CHAFO: Fiebre, gripe.
CHIMA KUTRHAN: Enfermedad venérea.
CHOIN: Parir. Es parte natural de vida de la mujer
que alguna vez trae consecuencia negativa de Salud
que surge la enfermedad.
CHULLUM KUTRHAN: Enfermedad de calambre,
mala circulación sanguínea.
CHULKUWG: Padastro.
EWANG: Arca, síntoma de vómito.
EPELALEI: Moribundo.
ELLAN: Cojo.
G-NFI KUTRHAN: Mal.
IAÑCHI KUTRHAN: Escalofrío.
KAFRH KUTRHAN: Amigdalitis, Disfonía.
KAICH KUTRHAN: Diarrea.
KETRHO: Mudo.
KUTRHAN: Enfermedad.
KUTRHANTUN: Dolor.
KUTRHANCHE: Persona enferma.
KMAU KUTRHAN: Ascaris.
LALATUN: Ataque.
MOI KUTRHAN: Forúnculo, divieso.
NRHNARH KUTRHAN: Sarpullido
PEGLLEN: Verruga.
PILU: Sordera.
PILUCHE: Gente con sordera, sorda.
PITRHU KUTRHAN: Erupciones cutáneas.
RHAPIÑ: Vómito.
RHLE KUTRHAN: Enfermedades con fiebre.
RHE KUTRHAN: enfermedad común, natural.
TRHALTRHALFE: Roncador.
UTRHUM KUTRHAN: Enfermedad a la vesícula.
WELUZUAM KUTRHAN: Demencia, trastorno
mental.
WEZAOTRHIN KUTRHAN: Mal de ojo.
WOIN KUTRHAN: Mareo.
PU:Los,Las.
PU:Entre,dentro.
CHI:el,la.
IENGU:Y,con.
Ka:otro,y.
KAI:Y.
NGI:Mio, de mi propiedad.
KIÑE:UN,uno,una.
KAFEI o KABEI : Tambien.
KAM:O.
MEU: en el , en la.
WELU : Pero.
AM : Nada.
AM : Alma.
FELEI O BELEI : bien.
TAMI:tu.
TAMU:su , de usted.
TAIU:Nuestro.
IAGUELTUWE : Comedor. 
ANTG WAI : Rayo de sol
GRHKTUWE : Lugar de descanso. 
AUKAN LIKAN : Poder alzado.
WITRHATRIPAWE : Baño.
AUKAN ALKA : Gallo alzado.
AIN : Querido, Amor.
AILEN : Brasa encendida.
AINKURHA : Piedra preferida.
AINKO : Agua preferida.
AINTUI : Se transforma en favorita.
ALIWENKO : Árbol de agua.
ALEN : Claridad de la noche.
ALIWEN : Árbol.
CHIWAI : Neblina.
LIENLEGFG : Río preferido.
ALONKURHA : Piedra luminosa.
ALON : Luminosidad nocturna.
ANTGMAN : Cóndor del sol.
ANTG CHIWAI : Neblina del sol.
AUKAN : Guerrero.
KALLFG : Azul.
KALLFG LLANGKA : Joya azúl.
KALLFG MAÑKE : Cóndor azú.
KALLFG KOIAM : Roble azúl.
KALLFG NAWEL : Tigre azúl.
KALLFG WENU : Cielo azulado.
KARHG LLAWEN : Frutilla verde.
KARHG LPI : Pluma azúl.
KARHG PANGI : León azúl.
ILWWEN RHAIEN : Rocío de flor.
ILWEN LAFKEN : Rocío del mar.
NGTANTU :Cama.
EKULL: Frazada
TAKUWE NGTANTU : Cubrecama
KAWITU : Catre.
PELONTUWE : Lámpara.
KARHU : Vaso.
RHALI : Plato.
CHALLA : Olla.
WITRG : Cucharon.
RHFUWE : Cucharon.
KCHALONKOWE : Champo.
FRHIKAWE : Sarten.
AFLKOFKEWE : Horno.
WEKUN RHUKA : Fuera de la casa.
WENTE RHUKA : Techo.
WALL RHUKA : Alrededor de la casa.
LILA : Patio.
KUDHI : Molino de piedra.
KURHAM : Huevo.
POÑI : Papa.
PIDHKU : Comida espesa.
ILHO : Carne.
ILHO KORHG : Cazuela.
CHALLWA ILHO : Carne de pescado.
IAFGTUN : Servirse, alimentarse.
KOLLM KOPIU : Copihue pintón. 
ÑAMKU : Águila.
LEMUN ANTG : Sol del monte. 
ÑANKUPEL : Cuello de águila
LEMUNKO : Agua de la montaña. 
PANGILEF : Puma veloz.
LEGFUKO : Agua de río.
PAILA KURHA : Piedra dada vuelta.
LEFI ÑANKU : Águila veloz. 
PAINE KURHA : Piedra celeste.
LIFKO : Agua limpia cristalina. 
PILLANG LIKAN : Poder del volcán.
LIG RHAIEN : Flor blanca. 
PILLMAIKEN : Golondrina.
LIG MAÑKE : Cóndor blanco.
RHAN KURHA : Piedra de plata
LIG KOIAM : Roble blanco.
RHELMU : Arco iris.
LONGKO MILLA : Cabeza de oro. 
RHELUN : Solo madera de lun.
LIKAN ANTG : Astro sol poderoso. 
WAIWEN : Viento del sur.
LLFKEN : Relámpago. 
WAIKIL : Flechero.
LLANGKA : Perla. 
WAIKILEF : Lanza veloz.
LLAGFEÑ ANTG : Sombra del sol.
WAIKI MILLA : Lanza de oro.
LLANGKATU : Collar. 
WANGLEN : Estrella
LLANGK TAPL : Hoja caída. 
WEIKO : Brote de agua.
MANGIL LEGFG : Río inundado.
WENTELIKAN : Sobre el poder
MAÑKE MILLA : Cóndor de oro.
WENU MAÑKE : Cóndor de la altura
MARHI LIKAN : Diez poderes/cuarzos.
WENULEF : Corredor de altura
MARHI WIÑO : Diez chueca.
WICHAL : Aliado
MAZAKAL : Pompones de adorno.
WILKI RHUKA : Nido del zorzal.
MELI PILLANG : Cuatro volcanes.
ZAKINGKO : Agua escogida
MILLALI : Similar al oro.
MILLLA RHEWE : Rhewe de oro.
MILLA LELFN : Campo de oro.
MILL WENU : Cielo dorado.
MILLAN : De oro. 
MILLA KURHA : Piedra de oro. 
MIZKI LAWEN : Medicina de la abeja.
MELINAG : Cuatro veces. 
NAWEL : Tigre. 
NAWEL KURHA : Piedra del tigre.
NEIN MAÑKE : Aliento del cóndor.
NEWENCHE : Persona fortacha.
iñche:yo.
eymi:tu.
fey:el,ella.
iñchiw:nostros dos, nostros
eymu:ustedes dos , ustedes.
fey engu:ellos,ellas.
TAÑI: Mi , de mio.
TAMI: Tu , de tuyo.
TAMU: Su , de ustedes dos . 
TAMN: Su , de ustedes más.
TAIU :Nuestro , de nosotros dos.
TAIÑ: Nuestro , de nosotros o más de dos . 